....................
....................
....................
....................
..........###.......
....................
....#####...........
....................
....................
......###...........
....................
....................
.........#####......
....................
####################
