....................................................................................................
....................................................................................................
....................................................................................................
....................................................................................................
..............................###...................................................................
....................................................................................................
..........#####.....................................................................................
....................................................................................................
...................................###..............................................................
....................................................................................................
..................................................#####.............................................
....................................................................................................
......................................................................###...........................
....................................................................................................
....................#####...........................................................................
####################################################################################################
